0000000000000000000000000
0991111999999911111111110
0991111999999911111111110
0111111999999911111111110
0111111999999911111111110
0111111111111111111111110
0111111111111111111111110
0111111111111111111111110
0011100000000000000000000
0111110111111111110111110
0111110111111111110111110
0111110111111119990111110
0991110111111119990001110
0991110111111111110001110
0991110111111111110001110
0111110111111111190001110
0111110011100000000001110
0111110111110111111111110
0111110111110111111111110
0111111111111111111111110
0111111111111111111111110
0111111111111111111111110
0111110111110111999999990
0111110111110111999999990
0000000000000000000000000
