000000000000000000000000000000000000000000000000000000000000
022222222222222222033333333333333333011111111111111111111110
022222222222222222033333333333333333011111111111111111111110
022222222222222222033333333333333333011111111111111111111110
022222222222222222033333333333333333011111111111111111111110
022222222222222222033333333333333333011111111111111111111110
022222222222222222033333333333333333011111111111111111111110
022222222222222222033333333333333333011111111111111111111110
022222222222222222033333333333333333011111111111111111111110
022222222222222222033333333333333333011111111111111111111110
022222222222222222033333333333333333011111111111111111111110
022222222222222222033333333333333333011111111111111111111110
022222222222222222033333333333333333011111111111111111111110
000000077777700000000000077777700000011111111111111111111110
066666666666666666666666666666666666611111111111111111111110
066666666666666666666666666666666666611111111111111111111110
066666666666666666666666666666666666611111111111111111111110
066666666666666666666666666666666666611111111111111111111110
066666666666666666666666666666666666611111111111111111111110
066666666666666666666666666666666666611111111111111111111110
066666666666666666666666666666666666611111111111111111111110
066666666666666666666666666666666666611111111111111111111110
066666666666666666666666666666666666611111111111111111111110
066666666666666666666666666666666666611111111111111111111110
066666666666666666666666666666666666611111111111111111111110
066666666666666666666666666666666666611111111111111111111110
000000077777700000000000077777700000011111111111111111111110
044444444444444444055555555555555555011111111111111111111110
044444444444444444055555555555555555011111111111111111111110
044444444444444444055555555555555555011111111111111111111110
044444444444444444055555555555555555011111111111111111111110
044444444444444444055555555555555555011111111111111111111110
044444444444444444055555555555555555011111111111111111111110
044444444444444444055555555555555555011111111111111111111110
044444444444444444055555555555555555011111111111111111111110
044444444444444444055555555555555555011111111111111111111110
044444444444444444055555555555555555011111111111111111111110
044444444444444444055555555555555555011111111111111111111110
044444444444444444055555555555555555011111111111111111111110
000000000000000000000000000000000000000000000000000000000000
