0000000000000000000000000000000000000000
0111111111111102222222222222222222222220
0111111111111102222222222222222222222220
0111111111111102222222222222222222222220
0111111111111102222222222222222222222220
0111111111111102222222222222222222222220
0111111111111102222222222222222222222220
0111111111111102222222222222222222222220
0111111111111102222222222222222222222220
0111111111111102222222222222222222222220
0111111111111102222222222222222222222220
0111111111111102222222222222222222222220
0111111111111102222222222222222222222220
0111111111111102222222222222222222222220
0111111111111102222222222222222222222220
0111111111111102222222222222222222222220
0111111111111102222222222222222222222220
0111111111111102222222222222222222222220
0111111111111132222222222222222222222220
0111111111111132222222222222222222222220
0111111111111132222222222222222222222220
0111111111111132222222222222222222222220
0111111111111132222222222222222222222220
0111111111111132222222222222222222222220
0111111111111132222222222222222222222220
0111111111111132222222222222222222222220
0111111111111132222222222222222222222220
0111111111111132222222222222222222222220
0111111111111132222222222222222222222220
0111111111111132222222222222222222222220
0111111111111132222222222222222222222220
0111111111111132222222222222222222222220
0111111111111132222222222222222222222220
0111111111111132222222222222222222222220
0111111111111132222222222222222222222220
0111111111111132222222222222222222222220
0111111111111132222222222222222222222220
0111111111111132222222222222222222222220
0111111111111132222222222222222222222220
0000000000000000000000000000000000000000
