0000000000000000000000000
0111111111111111111111110
0111111111111111111111110
0111111111111111111111110
0111111111111199999991110
0111111111111199999991110
0111111111119999999991110
0111111111119999999991110
0011100000000000000000000
0111110111111991110111110
0111110111111991110111110
0111110111111991110111110
0111110111111111110001110
0111990111111111110001110
0111990111111111110001110
0111990911111111100001110
0111110011100000000001110
0111110111110999999991110
0111110111110999999991110
0111111111111111111111110
0111111111111111111111110
0111111111111111111111110
0111110111110111111111110
0111110111110111111111110
0000000000000000000000000
