0000000000000000000000000
0777777777777777777777770
0777777777777777777777770
0777777777777777777777770
0777777777777799999997770
0777777777777799999997770
0777777777779999999997770
0777777777779999999997770
0088800000000000000000000
0666660555555995550111110
0666660555555995550111110
0666660555555995550111110
0666660555555555550002220
0666990555555555550002220
0666990555555555550002220
0666990955555555550002220
0666660088800000000002220
0666660444440999999993330
0666660444440999999993330
0666668444448333333333330
0666668444448333333333330
0666668444448333333333330
0666660444440333333333330
0666660444440333333333330
0000000000000000000000000
