0000000000000000000000000
0997777999999977777777770
0997777999999977777777770
0777777999999977777777770
0777777999999977777777770
0777777777777777777777770
0777777777777777777777770
0777777777777777777777770
0088800000000000000000000
0666660555555555550111110
0666660555555555550111110
0666660555555559990111110
0666660555555559990002220
0996660555555555550002220
0996660555555555550002220
0996660555555555590002220
0666660088800000000002220
0666660444440333333333330
0666660444440333333333330
0666668444448333333333330
0666668444448333333333330
0666668444448333333333330
0666660444440333999999990
0666660444440333999999990
0000000000000000000000000
