0000000000000000000000000000000000000000
0111111111111101111111111111111111111110
0111111111111101111111111111111111111110
0111111111111101111111111111111111111110
0111111111111101111111111111111111111110
0111111111111101111111111111111111111110
0111111111111101111111111111111111111110
0111111111111101111111111111111111111110
0111111111111101111111111111111111111110
0111111111111101111111111111111111111110
0111111111111101111111111111111111111110
0111111111111101111111111111111111111110
0111111111111101111111111111111111111110
0111111111111101111111111111111111111110
0111111111111101111111111111111111111110
0111111111111101111111111111111111111110
0111111111111101111111111111111111111110
0111111111111101111111111111111111111110
0111111111111111111111111111111111111110
0111111111111111111111111111111111111110
0111111111111111111111111111111111111110
0111111111111111111111111111111111111110
0111111111111111111111111111111111111110
0111111111111111111111111111111111111110
0111111111111111111111111111111111111110
0111111111111111111111111111111111111110
0111111111111111111111111111111111111110
0111111111111111111111111111111111111110
0111111111111111111111111111111111111110
0111111111111111111111111111111111111110
0111111111111111111111111111111111111110
0111111111111111111111111111111111111110
0111111111111111111111111111111111111110
0111111111111111111111111111111111111110
0111111111111111111111111111111111111110
0111111111111111111111111111111111111110
0111111111111111111111111111111111111110
0111111111111111111111111111111111111110
0111111111111111111111111111111111111110
0000000000000000000000000000000000000000
