000000000000000000000000000000000000000000000000000000000000
011111111111111111011111111111111111011111111111111111111110
011111111111111111011111111111111111011111111111111111111110
011111111111111111011111111111111111011111111111111111111110
011111111111111111011111111111111111011111111111111111111110
011111111111111111011111111111111111011111111111111111111110
011111111111111111011111111111111111011111111111111111111110
011111111111111111011111111111111111011111111111111111111110
011111111111111111011111111111111111011111111111111111111110
011111111111111111011111111111111111011111111111111111111110
011111111111111111011111111111111111011111111111111111111110
011111111111111111011111111111111111011111111111111111111110
011111111111111111011111111111111111011111111111111111111110
000000011111100000000000111111100000011111111111111111111110
011111111111111111111111111111111111111111111111111111111110
011111111111111111111111111111111111111111111111111111111110
011111111111111111111111111111111111111111111111111111111110
011111111111111111111111111111111111111111111111111111111110
011111111111111111111111111111111111111111111111111111111110
011111111111111111111111111111111111111111111111111111111110
011111111111111111111111111111111111111111111111111111111110
011111111111111111111111111111111111111111111111111111111110
011111111111111111111111111111111111111111111111111111111110
011111111111111111111111111111111111111111111111111111111110
011111111111111111111111111111111111111111111111111111111110
011111111111111111111111111111111111111111111111111111111110
000000011111100000000000111111100000011111111111111111111110
011111111111111111011111111111111111011111111111111111111110
011111111111111111011111111111111111011111111111111111111110
011111111111111111011111111111111111011111111111111111111110
011111111111111111011111111111111111011111111111111111111110
011111111111111111011111111111111111011111111111111111111110
011111111111111111011111111111111111011111111111111111111110
011111111111111111011111111111111111011111111111111111111110
011111111111111111011111111111111111011111111111111111111110
011111111111111111011111111111111111011111111111111111111110
011111111111111111011111111111111111011111111111111111111110
011111111111111111011111111111111111011111111111111111111110
011111111111111111011111111111111111011111111111111111111110
000000000000000000000000000000000000000000000000000000000000
