0000000000000000000000000
0111111111111111111111110
0111111111111111111111110
0111111111111111111111110
0111111111111111111111110
0111111111111111111111110
0111111111111111111111110
0111111111111111111111110
0011100000000000000000000
0111110111111111110111110
0111110111111111110111110
0111110111111111110111110
0111110111111111110001110
0111110111111111110001110
0111110111111111110001110
0111110111111111110001110
0111110011100000000001110
0111110111110111111111110
0111110111110111111111110
0111111111111111111111110
0111111111111111111111110
0111111111111111111111110
0111110111110111111111110
0111110111110111111111110
0000000000000000000000000
